Jesus 	Ipina
Cedar	Maxwell
Ronald	Willis
Gomis	Assebian
Alex	Ramirez
Erwin	Luevano
Sebastian	Reyes
Mauricio	Alfaro
Irene	Masabarakiza
Benjamin	Torres Alderete
Alexis	Galindo
James	Phillips
Cody	Eubanks
Santiago 	Medellin 
Ashton	Carlyle
Brenden	Fahd
Aaron	Luna
Jacob	Burleson
Troy	Burke
Sonia	Sandridge
Armaan	Hyder
Mario 	Pinto Sandoval
Noah	Rodriguez
Erika	Munoz
Monserrat	Morales
Jason	Bernal
Mary Faith 	Mitchell
Rodrigo	Lopez
Ian	Horbaczewski
Emily	Wallace
